左=Left
右=Right
胴=Waist
胸=Breast
胸揺れ=Breast
眉=Brow
腕=Arm
左腕=ArmL
右腕=ArmR
ワンピース=Dress
制服=Uniform
１=1
２=2
３=3
４=4
５=5
６=6
７=7
８=8
９=9
０=0
➖=-
胸部=Breast
右足=LegR
左足=LegL
※アバター用=*for Avator
アバター用=for Avator
Ａ=A
Ｂ=B
Ｃ=C
Ｄ=D
スカート=Skirt
素Body=Body
眼変形=Eye Deform
右目笑=EyeR Smile
左目笑=EyeL Smile
Backろ=Back
コア=Core
コアParts=Core
上腕=UpperArm
前腕=ForeArm
揺れ=Swing
位置=Position
収縮=Size
頬=Cheek
ハイライト=High Light
眼笑=Eye Smile
変形=Deform
Mouth内=Inside Mouth
頭頂部=Sinciput
手=Hand
アバターExport用=for Avator Export
Bodyunselected TexturesRotationY=Body Y

Left Eye Smile Face=EyeL Smile
Right Eye Smile Face=EyeR Smile
Bangs=Hair Front
Hair (as seen from the side)=Hair Side
Hair (as seen from the rear)=Hair Back
前=Front
後ろ=Back
リボン=Ribbon
影=Shadow
結び髪=Hair Part1
服=Clothes
襟=Collar
袖=Sleeve

