左=Left
右=Right
躯干=Waist
胸部=Breast
胸部物理=Breast
眉毛=Brow
手臂=Arm
左臂=ArmL
右臂=ArmR
裙子=Dress
制服=Uniform
１=1
２=2
３=3
４=4
５=5
６=6
７=7
８=8
９=9
０=0
➖=-
胸部=Breast
右腿=LegR
左腿=LegL
※アバター用=*for Avator
アバター用=for Avator
Ａ=A
Ｂ=B
Ｃ=C
Ｄ=D
裙子=Skirt
身体=Body
眼睛变形=Eye Deform
微笑右眼=EyeR Smile
微笑左眼=EyeL Smile
背面=Back
核心=Core
核心部分=Core
上臂=UpperArm
前臂=ForeArm
摇动=Swing
位置=Position
缩放=Size
脸颊=Cheek
高光=High Light
微笑眼=Eye Smile
变形=Deform
嘴内部=Inside Mouth
头顶=Sinciput
手部=Hand
用于形象导出=for Avator Export
Bodyunselected TexturesRotationY=Body Y

Left Eye Smile Face=EyeL Smile
Right Eye Smile Face=EyeR Smile
Bangs=Hair Front
Hair (as seen from the side)=Hair Side
Hair (as seen from the rear)=Hair Back
前=Front
后=Back
缎带=Ribbon
影子=Shadow
发型=Hair Part1
服装=Clothes
衣领=Collar
袖子=Sleeve

